R1-R1-R1-R1-R1-R1-R1-R1-R1-R1-R1-R1-R1-R1-R1-R1-R1
R1-A1-A2-A3-R1-A1-A2-A3-R1-A1-A2-A3-R1-A1-A2-A3-R1
R1-A4-A5-A6-R1-A4-A5-A6-R1-A4-A5-A6-R1-A4-A5-A6-R1
R1-A7-A8-A9-R1-A7-A8-A9-R1-A7-A8-A9-R1-A7-A8-A9-R1
R1-R1-R1-R1-R1-R1-R1-R1-R1-R1-R1-R1-R1-R1-R1-R1-R1
R1-A1-A2-A3-R1-A1-A2-A3-R1-A1-A2-A3-R1-A1-A2-A3-R1
R1-A4-A5-A6-R1-A7-A8-A9-R1-A4-A5-A6-R1-A7-A8-A9-R1
R1-A7-A8-A9-R1-G1-P1-G1-R1-A7-A8-A9-R1-G1-P1-G1-R1
R1-R1-R1-R1-R1-R1-R1-R1-R1-R1-R1-R1-R1-R1-R1-R1-R1
R1-A1-A2-A3-R1-A1-A2-A3-R1-A1-A2-A3-R1-A1-A2-A3-R1
R1-A4-A5-A6-R1-A4-A5-A6-R1-A4-A5-A6-R1-A4-A5-A6-R1
R1-A7-A8-A9-R1-A7-A8-A9-R1-A7-A8-A9-R1-A7-A8-A9-R1
R1-R1-R1-R1-R1-R1-R1-R1-R1-R1-R1-R1-R1-R1-R1-R1-R1
R1-A1-A2-A3-R1-A1-A2-A3-R1-A1-A2-A3-R1-A1-A2-A3-R1
R1-A4-A5-A6-R1-A4-A5-A6-R1-A4-A5-A6-R1-A4-A5-A6-R1
R1-A7-A8-A9-R1-A7-A8-A9-R1-A7-A8-A9-R1-A7-A8-A9-R1
R1-R1-R1-R1-R1-R1-R1-R1-R1-R1-R1-R1-R1-R1-R1-R1-R1